abdal	fool, idiot	naïf	simpleton
seme	seed	germ	spawn	milt	offspring	prime cause
but	thigh	ham
um	mind	intellect	wit
dar	gift
red	row	queue	order 	order 	line 
at	steed	Arabian 
car	czar, emperor, monarch
finale	finals
rat	war
god	name day	anniversary, holiday
voz	cart, wagon
us	fishbone
lampa	lamp
torta	cake
mapa	map 
kita	bunch, bouquet
nada	hope
mama	mom
led	ice	great frigidity, freezing cold	hail
let	flight
bog	god, deity
rod	gender	relative, relation	fruit, crop, extraction 	family, stock, lineage, kin, race
blud	bawdry, carnality, fornication
ring	the 
sat	hour
vermut	vermouth
bol	pain, aching
nit	thread	flow, continuity
list	leaf	newsletter, newspaper	calf 	sole, flatfish 
klub	club 	nightclub
klin	wedge	nail 
san	dream
pub	jack, knave in card games
maser	masseur
han	inn
brat	brother
ham	harness
sir	cheese
dud	mulberry 
cesta	road 	highway
pot	sweat
samuraj	samurai
baba	granny, grandma
pop	priest 
mast	grease	ointment	fat	lard	schmaltz
import	An 
vid	eyesight	eyeshot
kava	coffee
los	moose	elk
mit	myth
kaput	coat
papa	pope 
glad	hunger
roman	A novel 
pare	money
bes	rage	fury	madness	mania	tantrum	wildness	ferocity	rampage
puce	button
rosa	dew
formula	rule
juni	June
juli	July
vir	whirlpool
brav	male sheep or goat	wether
zona	zone, area
top	cannon
rob	slave
desert	dessert
lice	face
kip	statue
rub	rim	edge, brink
pero	feather, plume	plectrum	flange of a mace head
tor	corral, cote
ren	horseradish
lik	form, shape, figure, appearance	image, effigy
dom	home, house
zet	son-in-law
stolar	cabinetmaker	carpenter	woodworker
lira	lyre
presto	throne
beda	misery
dan	day
grab	hornbeam
vino	wine
tema	theme, subject
sestra	sister	nun, short for 	nurse, short for 
obor	cattle pen
sova	owl
peta	heel
maj	May
prst	finger	toe
ulica	street
metla	broom
žena	woman	wife
život	life
žaba	frog
žirafa	giraffe 
malina	raspberry 	raspberry 
mesto	place 	space	a settlement 
koza	goat
novelist	a 
starter	A device that starts an engine or a machine.
slon	elephant
stub	pillar
patron	protector
vez	knot	embroidery	needlework
kit	whale
gib	fold	joint
lista	list
monstrum	monster
narkoman	drug addict, junkie
stan	flat, apartment
porta	entrance
sisar	mammal
guma	rubber	tyre / tire	chewing gum
kondom	condom
telefon	telephone
kula	tower	turret	steeple	castle
pile	chick
pad	fall
pant	hinge
par	pair, couple
benzin	gasoline
insekt	insect
kamera	video camera
krava	cow 
sup	vulture
mačka	cat 
logika	logic
koža	skin	leather
kobra	cobra
fotograf	photographer
politika	policy
životopis	biography	curriculum vitae, CV
derviš	Dervish
ruka	arm	hand
cigareta	cigarette
kopija	copy, duplicate
vojna	military campaign
pokoj	rest	repose
matematika	mathematics
sendvič	sandwich
strana	side	party 	page 
brada	beard	chin
autobus	bus
trolejbus	trolleybus
fen	hair dryer
sirup	syrup
banka	bank
muž	husband
adresa	address
zub	tooth
velar	a 
jed	anger, rage, fury	bitterness, meanness, bile
tabor	camp
bina	stage
plot	fence
afinitet	affinity
autor	author
čaj	tea
gad	a repulsive person	scoundrel	cad	asshole	snake; lizard
col	inch
diktator	dictator
vest	report, news
transfer	transport
limit	boundary	boundary that cannot be surpassed
primer	example, instance	model, paragon	precedence
kuna	marten
plug	plough
cena	price	value, worth
hir	whim, caprice
limar	tinsmith, tinman, tinner
lav	lion 
poligon	polygon
hazard	gamble, gambling
paragraf	paragraph
alfabet	alphabet
defter	notebook
hod	walk, gait	pace
lavabo	sink, washbasin
mig	wink	hint	cue
mir	peace	calm, tranquility
patina	A type of wine.
raj	heaven, paradise
rep	tail
strop	A ceiling
tas	cymbal	the plate part of a traditional balance or scale
vis	summit 
sag	carpet, rug
sled	sequence	track
laguna	lagoon
tip	type
gat	ditch	dam
rame	shoulder
biro	office
avion	airplane, aeroplane	aircraft
kuka	hook
ketchup	Alternative form of 
firma	firm, company
oda	ode
dim	smoke
slog	syllable	stack, pile
meh	blower, bellows	goatskin, wineskin
post	fast, fasting
sila	force	strength	power	violence
drum	road
parabola	parable
ananas	pineapple
nebo	sky	heaven, firmament	air	atmosphere
raga	old horse, nag
fond	fund
jug	south
stupa	A pounding-mill, stamp-mill for grain, the contrivance where corn had to be pounded in hollow blocks before the meal mill has been invented.
paprika	bell pepper, pepper, 
alveolar	an 
hula	blasphemy
amok	Condition of 
akra	an outlying part of the body; extremity
kuk	hip
veranda	balcony	patio
gudura	gorge, ravine
bela	belote
volfram	tungsten
blato	mud
minus	minuns, defect, deficiency
bubalo	bug	beetle	insect
sfera	sphere, ball, globe	area, region
koska	a big bone
forma	form, shape	form, condition
fagot	bassoon
minder	mat	cushion	divan 
pena	foam
hrana	food
tabu	taboo
flauta	flute
nivo	level
aktiva	assets
aktiv	active voice	a group of activists
bordel	brothel
smaragd	emerald
homograf	homograph
lek	medicine
glas	voice	vote
bora	wrinkle
kismet	fate
defile	march-past
ud	limb
memorandum	letterhead
glib	mud, mire
dah	breath	breathing, respiration	stench, odor
solar	bullary worker
atmosfera	normal atmospheric pressure
abakus	abacus
kvar	defect, fault
kan	khan
meta	target
foton	A photon
alfa	alpha; the Greek letter Α, α
sabor	assembly	parliament
harpun	harpoon
jugo	sirocco 	ostro 
argo	slang
mikroskop	microscope
teleskop	telescope
vaga	balance, scales 
slava	glory	fame	feast
boca	bottle
dolina	valley, especially one in limestone	dale
konvoj	convoy
cimbal	a cymbal
cimbalo	cymbal
keramika	ceramic or ceramics	earthenware
simbol	symbol
znak	sign	symbol
oznaka	marking, mark
timpan	timbrel
def	daf	tambourine
carica	czarina, tsarina	empress
lešnik	a hazelnut
gospodin	gentleman	mister	Mr.	sir
votka	vodka
gitara	guitar
lipa	any part of a linden tree	tea made from linden flowers	linden tree, lime tree 
leto	summer, summertime
tel	silver or golden thread or string for sewing or embroidering
sunce	sun	sunlight
oblak	cloud
rečnik	dictionary
hurma	date 	persimmon 
novembar	November
oktobar	October
sreda	Wednesday
petak	Friday
subota	Saturday
opis	description
roda	stork
štrk	an insect of the families Oestridae, 
množina	a large amount
oman	the related and similar 
burma	wedding ring
vojvodina	voivodeship, dukedom
feder	spring 
rog	horn	antler	cornucopia
plato	plateau
mrs	food containing meat and animal fat	fast-free/non-fast days
java	reality	The state opposite of the sleeping or dreaming state, wakefulness.
maler	painter
piramida	a pyramid
arabica	A form of the Perso-Arabic script once used to write Serbo-Croatian.
tim	team 
jod	iodine
reka	a river
rijeka	river
zemlja	soil	land	dirt	ground	country
ime	name
biologija	biology
automobil	car
jogurt	yogurt or yoghurt
kvadrat	square
zvezda	a star
dlan	the palm of the hand
stablo	a tree trunk	a tree
jež	hedgehog
veo	veil
kalif	caliph
hram	temple	shrine	holy ground
zver	beast, wild animal
fakir	faqir
stepen	level	stage	extent	grade	exponent
autostop	hitchhiking
narod	people	nation	folk
čovek	man, person	human	person of integrity, mensch
kosmonaut	cosmonaut, astronaut
smoking	tuxedo, dinner jacket
tuš	shower
šala	joke	jest	prank	a bit of fun
aman	pity	mercy	compassion	forgiveness
strela	arrow
škola	school
fakultet	faculty
akademija	academy
arhanđel	archangel
abortus	miscarriage
ovan	ram: a male sheep
marcipan	marzipan
tragedija	tragedy
abeceda	alphabet
pismo	alphabet	letter, epistle	script, font
papir	paper
tavan	attic
balerina	ballerina
tangerina	tangerine	mandarin; mandarine
parlament	parliament
iva	osier
jantar	amber
pošta	mail, post	post office
pivo	beer
koma	coma
balet	ballet
ivrit	the Hebrew language
sabat	Sabbath
otava	aftergrass, aftermath; grass that comes up after mowing
tuce	a dozen	an unspecified large amount
pesma	poem 	song
vođa	leader, guide
borer	drill bit	drill
klon	clone
pozer	poseur
akter	participant	actor
poni	pony
dinosaurus	dinosaur
viski	whiskey/whisky
katedrala	cathedral
sok	juice
đus	juice	sap
bijes	rage	fury	madness	mania	tantrum	wildness	ferocity	rampage
jutro	morning	Old unit for measurement of area, similar to acre.
majka	mother
otac	father
klavir	grand piano
kič	kitsch
ćuran	a male turkey
meso	meat
luster	chandelier
planer	planner
kivi	kiwi fruit
saksija	a plant container	a flowerpot	jardiniere
listopad	fall of leaves
vakuum	vacuum
horizont	horizon
teme	top, apex
dinar	coins in Spanish playing cards
gigant	giant
seta	sorrow, melancholy
slonica	female elephant
bara	puddle
lugar	ranger, forester
religija	religion
stari	old man
kalendar	calendar
trava	herb
filozofija	philosophy
opna	membrane, film, pellicle, cuticle
pidžama	pajamas; pyjamas
vika	shouting, screaming
kultura	culture	manners	civility
beduin	bedouin
hidžab	hijab
glagol	verb
kesten	chestnut
jesen	autumn / fall
istok	east
kafa	coffee
nož	knife	blade
cunami	tsunami
cifra	digit	figure	number, numeral
grana	branch	field, branch
kolo	wheel	level, phase, volume, round, stage
delfin	dolphin 
vatra	fire
peć	furnace	stove	oven
badem	almond	almond tree
vaza	vase
zlato	gold 	objects made of gold collectively
etimologija	etymology
flaša	bottle
dete	child, kid
globus	globe
proteza	prosthesis
bridž	bridge 
perla	pearl	bead
zid	wall
kost	bone
tekst	text
eksperiment	experiment
golub	dove, pigeon
kamila	camel
šator	tent
boks	boxing 
fantom	phantom
taksi	taxi
pšenica	wheat
riža	rice
orkan	strong wind
lepota	beauty
marama	kerchief
stil	style
kometa	comet
televizor	a television set
parola	motto, slogan
kamen	stone
biblioteka	library
sirena	mermaid	siren
okrug	district	area	zone	province
ikebana	mishmash
masa	mass
parada	parade
etapa	stage, phase
figura	figure	figurine
oblast	district, region	area, zone	province
vitrina	vitrine	showcase	display cabinet	china cabinet
pipa	faucet, tap
teste	dozen, a bundle of twelve
gaz	ford, shallow place
portret	portrait
alternativa	alternative	alternative lifestyle
bomba	bomb
palma	palm-tree
duh	ghost, spirit	spirit
duša	soul	spirit
tortura	torture
brigada	brigade
cisterna	cistern
pekar	baker
vuk	wolf
mito	bribe
dno	bottom
uže	rope, cord
majmun	monkey 
vek	century 	a long period of time, especially historical; an era	lifetime
manastir	monastery	cloister
procent	percent	percentage
kuma	godmother	goodwife, gossip
plamen	flame, blaze, fire
brod	ship
iskra	spark
santa	iceberg
samur	sable 
fascikl	folder 
heraldika	heraldry
advokat	advocate, attorney, lawyer
doktor	doctor, physician	doctor, PhD
dama	lady
mečka	she-bear, female bear	show-bear, trained bear that performs at fairs
vidra	otter
rigor	rigour
vitez	knight 
tama	darkness
noć	night
večer	evening
veče	evening
ameba	amoeba
ulje	oil
aleja	alley
onomatopeja	onomatopoeia
nacija	nation
domovina	homeland
država	country	state
cvet	flower	blossom, bloom
behar	blossom
pijaca	bazaar	open air market	piazza	showroom
piće	drink, beverage
musliman	a male follower of Islam; a Muslim.
harmonikaš	accordionist
kuga	plague
harmonika	accordion
pingvin	penguin
velosiped	velocipede
tara	tare
pup	bud, burgeon
paun	peacock
oaza	oasis
liska	leaf 
liturgija	liturgy
sob	reindeer
gazela	gazelle
dinja	cantaloupe	melon
gušter	lizard
uragan	hurricane
noga	leg
glista	earthworm
farba	paint	color, tint	dye, colourant
boja	color, tint	dye, colourant	suit in card games
mozaik	mosaic
česno	clove 
apotekar	pharmacist
apoteka	pharmacy
zvuk	sound
železo	iron
breme	burden, load
nena	grandmother	grandma	granny	old woman
kist	A brush.
grof	count	earl
tigar	tiger 
pogan	excrement	dirt, filth	an evil, nasty person	something disgusting	Gentile
ekskrement	excrement
platina	platinum
nemoral	immorality
atelje	atelier
vazal	vassal
harfa	harp
koridor	corridor
salon	living room
merak	Desire, yearning, and enjoyment thereof	Enjoyment of the simple things in life
grom	thunder
fazan	pheasant
kukuruz	corn	maize
kukuruza	cornbread
polje	field
reformist	reformer
celofan	cellophane
konsonant	consonant
suza	tear
rez	cut	incision
hor	choir
jamb	iamb
planina	mountain
gora	mountain
marka	stamp, label	convertible mark	brand, label, trade name
dolar	dollar
sorta	sort, kind
horda	horde
džihad	jihad
glupak	stupid person, fool, ignorant
budala	fool	idiot	simpleton
sindi	Sindhi 
rika	roar, roaring
alat	tool	instrument
bure	barrel
kreda	chalk	Cretaceous
tegla	jar
aligator	alligator
vata	cotton wool
prag	threshold	doorstep	fingerboard, fretboard of a stringed instrument
smrt	death
carina	customs
hotdog	hot dog
republika	republic
javor	maple
obraz	cheek	honor	face
apatrid	A stateless person.
flota	fleet
grah	bean	bean soup
priča	story, tale	idle talk, prattle	rumor, hearsay
gaza	gauze
ambra	ambergris	amber 
norma	rule	norm
hvala	praise
kralj	king
dob	age
damar	vein, blood vessel	muscle	muscle tissue
kap	drop
pire	mash
roba	merchandise, commodity
nazar	evil eye
urok	evil eye	curse
rak	crab
rima	rhyme
pega	freckle
tesar	carpenter
lan	flax
vod	conduit
lom	fracture	breach, breakage	rumpus, ruckus, uproar
bura	bora 
balta	ax, axe
kora	crust
kanta	can	pail
tele	calf
medved	bear 
pauk	spider
mak	poppy
potok	brook, stream
raž	rye
roj	swarm
nar	pomegranate
jelen	male deer, buck, stag
pisar	scribe	registrar
mera	measure	dimension, size	rate	degree	extent	unit
stotinka	hundredth
div	giant
kupa	cup, goblet	cups in Spanish playing cards
oba	both 
fatum	fate, destiny
šećer	sugar
fosfor	phosphorus
ugar	fallow land
stih	verse
resa	tuft
boj	battle
apel	appeal, call
maz	ointment
glina	clay
buk	cascade, rapids, cataract	waterfall	the sound of a strong water stream
doba	time	age, epoch, era
ksenon	xenon
obrok	meal	portion
trud	effort, work, toil
trup	torso, trunk, body
pora	pore
ruda	ore, mineral
mrav	ant
kiša	rain
mati	mother
vetar	wind	erysipelas
sneg	snow	television static
unuk	grandson
čast	honour
sekund	second 
čas	moment
ukaz	order, decree, ukase
mesec	moon	month
mjesec	moon	month
godina	year
zastava	flag
puž	snail
testo	dough
gost	guest
četka	brush
magla	fog
rov	ditch
igla	needle
sito	sieve
sidro	anchor
bajka	fairy tale
brak	marriage
briga	worry, concern	trouble, bother	care; nurture
buna	rebellion, uprising, mutiny
domar	janitor
duga	rainbow
gazda	landlord	master	host
greda	beam 
grob	grave
kob	fate	destiny	omen
korpa	basket
krug	circle	circuit	lap
kut	corner	angle
labud	swan
lakat	elbow
lim	sheet metal
lopata	shovel
losos	salmon
misao	thought
polica	shelf	policy
rupa	pit, hole
salo	lard	fat 
sloboda	freedom
sluga	servant
vuna	wool
zob	oat
glog	hawthorn, whitethorn
jagoda	strawberry
telo	body
brazda	furrow	rut	crease
britva	razor
čun	a small shallow boat
puto	pastern
kanu	canoe
safer	Safar, the second month of the Islamic calendar.
mula	mule 
telur	tellurium
sena	shadow	silhouette	shade	umbrage	ghost	wraith	adumbration, shading	hatching
krap	carp
kamin	hearth, fireplace
cev	tube	duct	pipe
svraka	magpie
kozak	Cossack
rešeto	sieve
peka	iron pan for baking bread
kokos	coconut
lov	hunt, hunting	chase, pursuit	catch, haul
aga	agha
armatura	armature, reinforcement
enciklopedija	encyclopedia
zmija	snake
sreća	happiness	luck	fortune	a lucky outcome
gnoj	manure, dung	fertilizer, compost	pus, suppuration
grč	cramp	spasm
zrno	grain	kernel	bullet
kapak	eyelid	lid
krčma	pub
vrh	peak	summit	top	extremity	alp
puška	rifle
štuka	pike 
vreme	time	weather	epoch
ruho	clothes, attire, garment
stup	pillar
unuče	grandchild
biser	pearl
bivol	buffalo
dvor	castle	palace	courtyard, court
užina	snack 
kaša	porridge
kovač	smith	blacksmith
koš	basket
kotlina	basin, ravine, hill-encircled valley
vlast	power, control	authority
vrša	fish-trap
zalog	pawn	pledge
dil	deal 
mlin	mill	grinder
sapun	soap
palica	bat	rod	cane
pehar	cup
pleva	chaff
pogača	unleavened bread
pokop	burial
puh	dormouse
broj	number
načelnik	chief
upala	inflammation, pneumonia
ris	lynx
srp	sickle
kramp	pickaxe
smak	end, termination
salama	salami
soha	branching tree
atar	region, district, area, land
ded	grandfather
profesor	professor
pravda	justice
stara	old woman
blok	block of flats
taht	throne
policija	police
granica	border	boundary, limit
spis	document, text
bič	whip
pozor	attention
dokument	document
esej	essay
niz	array, sequence, series	row	string	large number of, host of, a number of 
purger	burgher	a citizen of Zagreb
savez	alliance, union	association	coalition	league	confederation	covenant
beton	concrete
odar	bier	catafalque
jaje	egg
zubar	dentist
krater	crater
melek	angel
marica	police van, paddy wagon
zarf	envelope	armor, cover
šara	pattern	design	color
litra	litre/liter
astma	asthma
krem	cream, creme
dina	dune
membrana	membrane
arhitektura	architecture
bufalo	buffalo
kal	mud
diktat	dictate
kidnaper	kidnapper
kasta	caste
gnus	a repulsive person	scoundrel	cad	asshole	vermin
konstanta	constant
lema	lemma
perut	dandruff
posed	possession, ownership
beba	baby
aloja	aloe
debata	debate, discussion
disciplina	discipline
glosar	glossary
mimar	architect	builder
sudar	crash	collision
lijes	coffin
panteon	pantheon
reforma	reform
remen	strap
titula	title
sujeta	ego; vanity
suma	sum, total
metak	bullet
suvenir	souvenir
plac	market	space, area
lagum	mine	underground tunnel	cellar
heroina	heroine
antikvitet	antique
ateist	atheist
aparat	apparatus
antre	entrée
čelo	forehead
profiter	profiteer
peh	bad luck, misfortune
robotika	robotics
erbij	erbium
čizma	boot
poset	visit
nomenklatura	nomenclature
pička	 
rende	grater for food preparation	smoothing plane
keks	cookie 	cracker
leja	plot of land for sowing, a partition of agriculturally or horticulturally used earth, farming bed
gladiola	gladiolus
malarija	malaria
recept	prescription	recipe
puding	pudding 
lutka	doll, puppet	a nice-looking girl or woman	darling	pupa
boem	bohemian
afrikans	Afrikaans 
čalma	turban
publika	audience
temperatura	temperature
panteist	pantheist
interlingva	Interlingua
riva	bank, shore
alkohol	alcohol
autostrada	highway
etiketa	etiquette	tag	label
filozof	philosopher
bazen	swimming pool	pond
volan	steering wheel
kapital	capital 
kube	little stove
sperma	sperm
kredo	credo, creed
kabel	cable
konjak	cognac
šerbe	sorbet	sherbet
šerbet	sorbet	sherbet
tapeta	wallpaper
krokodil	crocodile
bizon	bison
tvor	skunk 	polecat 
kolibri	hummingbird
lakros	lacrosse
paronim	paronym
anakonda	anaconda
akrobata	acrobat
biografija	biography
frontmen	frontman
rentgen	röntgen
žuč	bile
žito	cereal, grain	koliva
kofein	caffeine
jezero	lake
koleno	knee	joint, bent	knot	knuckle	angle	generation, descent	family, race, house
porota	jury
bolest	sickness, disease
bik	ox, bull
drozd	thrush 
horoskop	horoscope
konto	account, registry
abonent	subscriber
abraziv	abrasive
avans	advance, advance payment
agrumi	citrus fruits
bajta	shack, hut, cottage	small and humble house
barka	boat 
bokal	jug
nikotin	nicotine
potomstvo	offspring, descendants, posterity, progeny
kojot	coyote
stopa	foot 	rate, step
prase	piglet
džungla	jungle
šakal	jackal
struna	horse-hair
želva	sea turtle
ubrus	towel	serviette	napkin
usklik	exclamation, shout	interjection
čin	action, act, deed
instinkt	instinct
bećar	bachelor	an unmarried man
mezanin	mezzanine
skupina	group 
grupa	group
slabost	weakness
kompas	compass
ćilim	thick carpet or tapestry of oriental style
saboter	saboteur
lenost	laziness
sekta	sect
prut	rod, stick, staff
značka	badge	badge button
prevod	translation
većina	majority, most	greatness	bulk
služba	service	employment, job	office, work	duty	divine service, ministry
rukav	sleeve
baza	base	basis
ambar	barn	granary	silo
fregata	frigate
opat	abbot
biskup	bishop 
salata	salad
sangvinik	sanguine person
zločin	crime
referat	report
veslo	oar
karta	card	ticket
semantika	semantics
semafor	semaphore	traffic light
kiks	blunder
mrak	dark, darkness
kandidatura	candidacy, candidature
kibernetika	cybernetics
pokal	bowl, goblet	cup
klinika	clinic
komanda	command	control	crew	headquarters
komitet	committee
husar	hussar
konstruktor	constructor
kontakt	contact
kotlet	cutlet
kran	crane
kreditor	creditor
kosinus	cosine
kulisa	coulisse
kupon	coupon
kurs	course 	course, direction	exchange rate
ekvator	equator
epitet	epithet
eskalator	escalator
procedura	procedure
metateza	metathesis
dragun	dragoon
laborant	laboratory technician
sarma	a type of food from meat rolled with leaves
lirika	lyric
orman	ambry, closet, wardrobe
pozdrav	greeting, salutation
cenzura	censorship
sinonim	synonym
antonim	antonym
safir	sapphire
mikrob	microbe
mikrofon	microphone
miting	mass meeting 
faktor	factor
paket	packet	package	parcel
fenomen	phenomenon
fizika	physics
fokus	focus
valuta	currency
fonetika	phonetics
šipka	rod	bar, ingot
nega	care, nursing
kopar	dill
statistika	statistics
prezervativ	condom
slatko	dessert	sweet
pećina	cave
parazit	parasite
radikal	radical
kolega	colleague
mah	swing, wave, sweep 	moment, instant
zoologica	zoologist
gradivo	material, matter 	study material
tona	tonne
palata	palace	mansion
opit	experiment
solana	saltern
puran	male turkey 
raketa	rocket	missile
satelit	satellite
gramatika	grammar
udar	stroke, hit	attack, strike	impact
sos	sauce
tramvaj	tram	tramcar	streetcar	trolley car
vezir	vizier
kmet	peasant, villager	village major or leader
nevesta	bride
mlada	bride
eksport	export
reket	racket 	racket 
klaun	a silly, irresponsible person
lokomotiva	engine, locomotive
vrt	garden
lipan	grayling
motiv	motif
stratosfera	stratosphere
troposfera	troposphere
centrifuga	centrifuge
maharadža	maharajah
luksus	luxury
ventil	valve
slitina	alloy
trampa	barter
repetitor	repeater
replika	reply
osoba	person
resurs	resource
refleks	reflex
reflektor	spotlight
puk	folk, people
milost	mercy, compassion, favour
kurban	victim	sacrifice
sklad	harmony, accord, congruity
soj	type, kind, sort	lineage, stock
kuća	house
lavina	avalanche	landslide
mena	change	phase	lunation
predika	lecture	homily
skener	scanner
porod	birth	delivery of a child	children, progeny
zadruga	commune, cooperative
asfalt	asphalt, asphalt concrete
lokal	business premises	bar, night club
komora	larder, pantry, closet, boxroom or utility room	chamber, house 	ventricle 	chamber, container, compartment 
strava	horror, dread
projektor	projector
član	member 
falus	phallus
sirota	orphan	an unfortunate
servis	service
ogled	assay, experiment	test, trial
lapsus	lapse
kri	blood
čičak	bur	velcro
nepravda	injustice
atribut	attribute
šifra	code, cipher 	password, passcode
pauza	break, pause
saksofon	saxophone
maraton	marathon
hašiš	hashish
cezura	caesura
geometrija	geometry
ruža	rose
kukac	insect	bug	beetle
rutina	routine
metamorfoza	metamorphosis
platforma	platform
sistem	system
štit	shield
leglo	brood
klasifikacija	classification
konstrukcija	construction
bazalt	basalt
boksit	bauxite
kaskada	cascade
šuma	forest, woods
homonim	homonym
kajak	kayak
hiponim	hyponym
hiperonim	hypernym
kompjuter	computer
oponent	opponent
protivnik	opponent	competitor
konkurent	competitor
antropolog	anthropologist
ornitolog	ornithologist
farmakolog	pharmacologist
inhalator	inhaler
kamara	room
literatura	literature
taksa	administrative fee
anglicizam	anglicism
granata	grenade, hand grenade
nacionalizam	nationalism
antagonizam	antagonism
anabolizam	anabolism
idealizam	idealism
internacionalizam	internationalism
magnetizam	magnetism
organizam	organism
racionalizam	rationalism
realizam	realism
vandalizam	vandalism
silueta	silhouette
antropologija	anthropology
astrologija	astrology
bakteriologija	bacteriology
klimatologija	climatology
dendrologija	dendrology
ekologija	ecology
perioda	menstruation	a period 
akuzativ	the accusative case
lokativ	the locative case
poslušnost	obedience, dutifulness
sekira	axe
sekirica	hatchet, a small axe
tomahavk	tomahawk 
zlo	evil	evilness	maleficence	harm	ill
leksem	lexeme
morfem	morpheme
fonem	phoneme
fonologija	phonology
grafem	grapheme
alomorf	allomorph
afiks	affix
prefiks	prefix
sufiks	suffix
alofon	allophone
anafora	anaphora
nazal	a nasal
nosnik	a nasal
savet	council	advice	counsel
agresija	aggression
sociologija	sociology
pragmatika	pragmatics
inteligencija	intelligence
kontribucija	contribution
geografija	geography
genealogija	genealogy
ekosistem	ecosystem
biofizika	biophysics
akustika	acoustics
teorija	theory
kompilator	compiler
ontologija	ontology
vikend	weekend
muzika	music
arija	aria
džez	jazz
konflikt	conflict
krajina	border area, frontier area	region, area
brdo	hill
jahta	yacht
novinar	journalist
žurnalist	journalist
šaht	manhole
leksikologija	lexicology
leksikograf	lexicographer
ferije	vacation, holiday
stomak	stomach	belly
dabar	beaver
jaram	yoke
manjak	deficiency	deficit	shortfall	shortage
palac	thumb
ražanj	barbecue spit, skewer
višak	excess	surplus	superfluity	overage	plethora
visak	plumb line
starac	old man
ataše	attaché
intervju	interview
embrio	embryo
foaje	foyer
renome	reputation
broš	brooch
djed	grandfather
knez	prince
miš	mouse
trag	trace
vrag	devil
crv	worm	vermin
ptić	a little bird; fledgling
jad	misery	distress	bitterness	grief
žrec	a pagan priest
gospodar	master, lord	voivod
bife	buffet
dinamo	dynamo
gaučo	gaucho
stav	posture, stance, position	attitude, opinion, sentiment
mladić	young man, lad
vakat	moment	hour	time
abažur	lampshade
abonos	ebony
acetilen	acetylene
aceton	nail polish remover
adaptacija	adaptation
adjunkt	assistant
administracija	administration	administrative apparatus, paper work
aneks	annex
adresant	addresser	forwarding agent	remitter
adresar	directory	address book
bratstvo	brotherhood	fraternity
agresor	aggressor
akademik	academician, academic
akcija	action	share 
akrobat	acrobat
akumulator	accumulator
akvarel	watercolour
alergija	allergy
amater	amateur
ambasador	ambassador
ambicija	ambition
analfabet	analphabet
analiza	analysis
analizator	analyst	analyzer
analogija	analogy
anarhija	anarchy
anarhist	anarchist
anatomija	anatomy
anketa	poll, inquiry, questionnaire
ansambl	ensemble
antena	antenna
antilopa	antelope
aperitiv	apéritif
apetit	appetite
arak	double sheet
asistent	assistant 
atentat	assassination
automobilist	driver	sports car driver
bakalar	cod
balast	ballast
balon	balloon
balzam	balsam
bankrot	bankruptcy
baraka	shack, hut
barikada	barricade
baterija	battery	flashlight
bedro	thigh
afekt	affect
afera	scandal
afrikanist	Africanist
agentura	agency	cover-up organization
sintaksa	syntax
agnostik	agnostic
agregat	motor generator 
agresivnost	aggressiveness
ahat	agate
ajvar	caviar
akacija	acacia
akcelerator	accelerator
akcent	emphasis
metoda	method
kozmetika	cosmetics
ekonomija	economy
entomologija	entomology
gimnastika	gymnastics
žurnalistika	journalism
meteorologija	meteorology
mitologija	mythology
numizmatika	numismatics
ornitologija	ornithology
fotografija	a photograph, picture	photography
psihologija	psychology
sleng	slang
žargon	jargon
akcionar	shareholder
aker	acre
akronim	acronym
aksiom	axiom
aktivist	activist	civic-minded person
aktovka	briefcase
aktualitet	topicality	actuality
akvedukt	aqueduct
alaun	alum
alegorija	allegory
alergolog	allergist
alka	metal ring	door knocker	tilting at the ring 
alkar	tilter at the ring
krmivo	fodder 
almanah	almanac
alpaka	alpaca
alpinistika	alpinism
alrauna	mandrake
mandragora	mandrake
altist	altoist
nemar	negligence	carelessness	slackness	unconcern, indifference
amanet	pledge
ponor	abyss
amblem	emblem
adresat	addressee
aeronautika	aeronautics	aviation
amerikanist	Americanist
amerikanistika	American studies
ametist	amethyst
amfibija	amphibian	amphibious vehicle
amfibrah	amphibrach
amfora	amphora
ampir	empire style
amplituda	amplitude
ampula	ampoule
adzuki	azuki bean
ostava	pantry, larder
kazalo	table of contents
agogika	agogics
agoge	agogics
agami	grey-winged trumpeter
agava	agave
akupunktura	acupuncture
akupresura	acupressure
akvamarin	aquamarine
akvatinta	aquatint
alveola	alveolus
feniks	phoenix
anamneza	anamnesis
anastrofa	anastrophe
anatema	anathema
anegdota	anecdote
anesteziolog	anesthesiologist
anglikan	Anglican
anglikanka	Anglican 
anglist	Anglicist
anglistica	female 
anglofil	anglophile
anglofob	Anglophobe
anoda	anode
katoda	cathode
anomalija	anomaly
reaktant	reactant
topologija	topology
identifikator	identifier
kombinatorika	combinatorics
tenzor	tensor
funkcija	function
popis	list, listing	census	inventory
matrica	matrix
simetrija	symmetry
kombinator	combiner, one who combines
kolektor	collector
kondenzator	condenser
kripton	krypton
cerij	cerium
talij	thallium
bizmut	bismuth
kobalt	cobalt
epik	epicist
okolnost	circumstance
marmelada	marmalade
džem	jam 
akt	act	painting of a naked person
antifona	antiphony
antika	antiquity
antikrist	antichrist 
antisemit	anti-Semite
antiteza	antithesis
antologija	anthology
antracit	anthracite
antraks	anthrax
antropomorfizam	anthropomorphism
kušin	pillow
abonman	subscription, prepayment
autostopist	hitchhiker
autobiografija	autobiography
autodidakt	autodidact
samouk	self-taught person; autodidact
aparatura	set of instruments
apatija	apathy
aplauz	applause
apoen	denomination 
apokalipsa	apocalypse 
apologet	apologist
azerbejdžanski	Azerbaijani 
azijat	mongoloid
azijatkinja	mongoloid 
forhend	forehand
bajt	byte
džemper	jumper 
džetset	jet set
džingl	jingle
džip	jeep
džojstik	joystick
džokej	jockey
džoker	joker 
džudo	judo
džul	joule
džus	orange juice
menadžer	manager
menedžer	manager
šejl	shale
breča	breccia
brendi	brandy
šeri	sherry
volej	volley 
vaterpolo	water polo
budžet	budget
ekspres	express
kombajn	combine 
kros	cross-country race
čarter	charter
mač	sword
ragbi	rugby
bojkot	boycott
šok	shock
šorc	shorts 
brik	brig 
kontejner	container
pank	punk 
kapela	chapel
kupe	coupé
napon	tension	voltage
fonon	phonon
tvist	twist 
utopija	utopia
vakum	vacuum
violina	violin
tiket	ticket
koktel	cocktail
kombi	station wagon
kongres	congress
porcelan	porcelain
šef	chief, boss, manager, director, head
plastika	plastic
kviz	quiz
kveker	Quaker
inženjer	engineer
misija	mission
najlon	nylon 
protokol	protocol
skandal	scandal
komentar	comment
ranč	ranch
rezerva	reserve
sako	jacket, sportcoat, blazer
sanskrt	Sanskrit
siže	subject, topic
abak	abacus
šipak	rosehip	briar	pomegranate
plač	cry	weeping
zakon	law, rule
gama	gamma, the Greek letter Γ, γ
smeč	smash 
pisač	printer 	burner
radost	joy
genetika	genetics
sprema	qualification, training
strofa	strophe
obzor	horizon
izvor	well, wellspring	source, origin
karakter	character
narcis	daffodil
vetrina	strong wind
plaža	beach
kugla	ball 	bowl	globe	sphere	bullet, shell	shot 
koketa	flirt, coquette
narodnost	nationality	ethnicity
pobratim	blood brother
gulaš	goulash
markiz	marquess
markiza	marchioness, marquise
vrba	willow	osier
ograda	fence, enclosure	banister, barrier, railing	reservation, limitation
sve	all, everything
pređa	yarn
oker	ochre
ruj	sumac
oktava	octave
gerila	guerrilla warfare
geto	ghetto
uš	louse
utroba	intestines	womb	bowel	entrails
vrat	neck
jeza	shudder, shiver	horror	thrill
teren	terrain
spiker	newsreader, announcer
spika	conversation, speech, talk
bukač	noisemaker
pokus	experiment	rehearsal
loza	vine	stem	lineage
teist	theist
zasluga	merit, credit
šablona	template, model, pattern
šunka	ham
pisac	writer	author
lažac	liar
nosač	porter, bearer, carrier	beam, girder
čudak	eccentric, crank
prostak	A rude person.	A vulgar person.
rođak	relative, cousin
župan	head of a district
sirotan	orphan	a pathetic, miserable or poor person
pravaš	a follower of the Party of Right
drogaš	drug addict
plam	flame 
lavež	barking, bark
metež	disturbance, uproar	confusion, chaos
gonič	hound, hunting dog
vodič	conductor	guide, leader, head	guidebook
komunist	communist
kolumnist	columnist
radiša	hardworking person
tolerancija	tolerance
gatara	fortuneteller
borba	fight	combat	struggle
perunika	iris
plavuša	a blonde woman
detektiv	detective
detektivka	detective
administratorka	A female adminìstrātor
petina	one fifth
pekarna	bakery
starost	age	old age
dobrota	goodness
čama	gloom, dreariness, bleakness	boredom, lethargy
tvorba	creation	formation
krasta	scab, slough
nužda	need	necessity
vlada	government
vime	udder
propast	collapse	destruction	downfall	damnation
slast	sweetness, delight
strast	passion
ćud	temper, temperament, mood, disposition	character, personality
draž	charm
drob	bowels, guts, intestines	offal
golet	bare countryside
laž	lie	untruth	falsity	fib
moć	power	ability, faculty	potency, might	influence, authority
nemoć	weakness, feebleness, faintness	impotence, powerlessness	infirmity	helplessness
pomoć	help
ponoć	midnight
rukovet	handful, bunch of
sluz	mucus
splav	raft, float
vlat	blade, stalk
žeđ	thirst
zavist	envy, jealousy
parostroj	steam engine
snaga	strength, power
nokaut	knockout
šminka	make-up
noj	ostrich
dečko	boy	boyfriend	jack, knave in card games
dragulj	gem
iglica	a small needle
uvod	introduction
visina	height	altitude
šupa	shed
šojka	jay 
mašta	imagination
usna	lip 
kliše	cliché
galop	gallop
brk	moustache	whisker
obad	gadfly
štene	puppy 
kravata	tie
slana	hoarfrost
šuga	mange
prišt	pimple
stolica	chair
gusak	gander
teret	burden	cargo	weight
ustav	constitution
nosorog	rhinoceros
prognoza	forecast
predmet	thing, object
težište	center of gravity
interpunkcija	punctuation 
spilja	cave, cavern
špilja	cave, cavern
krzno	fur, pelt	a fur coat or any other type of clothes made of fur
ples	dance
guša	goitre	gullet	throat
pseudonim	pseudonym
obala	bank	coast, shore	shoreline	coastline
sarkofag	sarcophagus
pinjin	pinyin
prostor	space	area, region
muzar	milker
ručka	handle, helve, haft, handhold
rukopis	handwriting	manuscript	typescript
ponos	pride
okup	gathering, assembly
livada	meadow
loj	tallow, suet, fat
loža	box 
sotona	satan
kvaka	handle 	A decisive detail in a legal document, computer program, algorithm etc. that enables or disables something; a catch.	háček
ured	office	bureau
orgija	orgy
kupac	buyer, purchaser
igrač	player
platno	linen	canvas
ribar	fisherman
lavica	lioness
usluga	favour
urednik	copy editor
opereta	operetta
hipoteka	mortgage
hipoteza	hypothesis
seljak	peasant, farmer	villager	countryman
seljanka	peasant woman	country woman
stonoga	centipede
obrazac	pattern, model
aritmetika	arithmetic
žuna	woodpecker
fanatik	fanatic
tava	frying pan	skillet
fakat	fact, factum
puter	butter
odora	robe, vestment	uniform
asimetrija	asymmetry
sonet	sonnet
jama	excavation, hole, cavity	hollow, depression	hole, burrow
lešina	carrion
metoh	church	monastery	glebe	churchyard
delo	work	piece of work	deed, act
mraz	frost	chill
brest	elm
lula	tobacco pipe
sef	safe, strongbox
tranzistor	transistor
koleda	carol
konak	inn, hostel	accommodation
trator	amaranth
tuberkuloza	tuberculosis
nosić	a small nose
umor	fatigue
lelek	wailing, weeping
defekt	defect, flaw
trener	coach
družba	group, social group	association
bajonet	bayonet
krama	junk, trash 
sojka	jay 
sedlo	saddle	ridge, saddle
lotos	lotus
savest	conscience
vokal	vocal, vowel
kumarin	coumarin
murina	moray 
savana	savanna
turist	tourist
veš	clothes, especially underwear	laundry	washing
opatija	abbey 
mošeja	mosque
čoban	shepherd
pornograf	pornographer
medo	bear	teddy bear
ruptura	rupture
skok	jump
butik	boutique
gibanje	movement
sinagoga	synagogue
epenteza	epenthesis
krah	ruin, disaster, crash
krik	scream, cry
kristal	crystal
celina	totality, whole, entirety	state of being total, with no missing parts
marioneta	marionette, puppet
klobuk	mushroom
aspekt	aspect
strategija	strategy
purgar	burgher	a citizen of Zagreb
nemir	disquiet, agitation, unrest, restlessness
maska	mask
pumpa	pump 
dilema	dilemma
morfema	morpheme
režim	regime, mode 	regime 
borje	pine forest
učilište	school	a place where one can study
pecivo	bun, pastry
pletivo	knitting material
jelo	meal	dish
pijanica	drunkard
koncern	concern, firm
epizoda	episode
fraza	phrase
kalk	calque
čajnik	teapot	kettle
cirkus	circus 
žezlo	scepter
gramofon	gramophone, phonograph
kategorija	category
taktika	tactics
konzul	consul
doboš	drum
karfiol	cauliflower
takt	rhythm, tempo	tact 
trubač	bugler	trumpeter
kajmak	kaymak	foam appearing on the top when making coffee
raspon	span	range
znoj	sweat
jajnik	ovary
božica	goddess
leksikon	lexicon
kartel	cartel
katalog	catalog, catalogue
celibat	celibacy
fajt	a fight
tetica	auntie
napad	attack, assault, aggression
reklama	advertisement, commercial 	advertising, publicity,  promotion
stranka	party in legal or administrative proceedings
garant	guarantor
potop	deluge, flood
ruter	router
soja	soya, soybean
čistka	purge
oboa	oboe
elita	elite
obrat	reversal, turning point
pojas	belt, girdle, band, sash	zone, area, biome
knut	knout
cenzus	census
promena	change
jajce	an egg
bivo	buffalo
sandala	sandal
bumbar	bumblebee
šaran	carp
pravopis	spelling	orthography
katedra	chair, department, cathedra 	cathedra 
lobi	lobby 	lobby 
spektakl	spectacle
zabava	fun, amusement	party	entertainment	distraction	diversion
oltar	altar
veličina	size
dekada	decade
mašina	machine	engine
panika	panic
kopra	copra
nektar	nectar
komponenta	component
himna	hymn
vizitka	business card
otvor	opening 
kritika	critique, criticism
teolog	theologian
stilistica	stylist
fakin	scamp, rascal
bogaz	gorge	pass
kolac	stake	pale
masturbacija	masturbation
komoda	commode, chest of drawers
budist	Buddhist
šarada	charade
instrukcija	instruction
paradoks	paradox
kanal	canal	channel
ralo	plow	plowshare
reč	word 
deda	grandfather
živost	vividness, liveliness
grejpfrut	grapefruit
doktorat	doctorate, doctoral degree	dissertation, doctoral thesis
demonstrant	demonstrator 
maslo	butter 	something that is of bad quality
kofa	pail	bucket
apostol	apostle
čudo	wonder, miracle	marvel
gnezdo	nest
sveća	candle
tlo	ground	floor
klip	piston	corncob
masakr	massacre
depresija	depression
prestiž	prestige
frizura	haircut, hairstyle, hairdo
tetiva	sinew, tendon
diftong	diphthong
tuga	sorrow, grief, dismal
ručnik	towel
krevet	bed
grb	coat of arms
biće	creature	being
kloroform	chloroform
prijem	admission	receiving, receipt, reception
homar	spruce
račun	computation, calculation	bill, invoice, check	account
oblik	shape, form, figure	configuration
odnos	relationship	ratio, rate
osnova	basis, foundation
prednost	advantage	precedence, primacy
skica	sketch 
perspektiva	perspective
monarh	monarch, sovereign
pristup	access 	approach 
pedofil	pedophile
pelikan	pelican 
bluza	blouse
pravnik	jurist	lawyer
prikaz	display, depiction, portrait	review, account	overview
krasopis	calligraphy
smer	direction, course
zgoda	episode, event	occasion, opportunity
kolumna	a newspaper column
magacin	depot	stockroom	storeroom, storehouse	warehouse	depository	shop
multiplikator	multiplier
generacija	generation
rezultat	result
efekt	effect	impression
informacija	information
pokret	move
ukop	burial, funeral	the act of laying the deceased into the grave
nagon	instinct
dezerter	deserter
koncept	concept
nacrt	sketch
definicija	definition
sinteza	synthesis
profesija	profession
proporcija	proportion
gospođa	Mrs.	lady 	lady of the house
onomastika	onomastics
bulevar	boulevard
komplement	complement
pomoćnik	assistant
organizacija	organization
omlet	omelette
način	way, method, approach, manner
atentator	assassin
hajduk	brigand, outlaw
sudnica	courtroom
naprava	device, gadget, appliance, apparatus
sprava	device, gadget	instrument, piece of equipment
cimer	roommate
klupa	bench
nadzor	supervision, oversight
struktura	structure
šumar	ranger, forester
šampon	shampoo
pikula	marble
šarlatan	charlatan, quack
zaštita	protection
špekulant	speculator
špekulacija	speculation
spekulacija	speculation
ideja	idea
zabrana	prohibition, ban
lupež	thief
šapat	whisper
emocija	emotion
ormar	ambry, closet, wardrobe
kontrast	contrast
egzistencija	existence
dinamit	dynamite
unca	ounce
žanr	genre
hereza	heresy
heretik	heretic
osmero	eight persons of different gender/sex
sedmero	seven persons of different gender/sex
šestero	six persons of different gender/sex
petero	five persons of different gender/sex
troje	three persons of different gender/sex
stomatologija	stomatology
dres	tracksuit
karneval	carnival 
magnetofon	tape recorder
buki	buky
kandidat	candidate; applicant
provala	burglary
karakteristika	characteristic, feature
makro	pimp
tarifa	tariff, fee
nukleus	nucleus
milion	million
imigrant	immigrant
rubrika	newspaper column or section	heading or section in a form	rubric
recenzent	reviewer
prababa	great-grandmother 
bifora	mullioned window
sponzor	sponsor
instruktor	instructor
bibliofil	bibliophile
tajnost	secrecy
šamija	scarf	headscarf
filantrop	philanthropist
odraz	reflection 	reflection 
dražba	auction
demokrat	democrat
nazor	view	opinion	belief
granat	garnet
maskota	mascot
predak	ancestor, forefather, progenitor	predecessor
naivnost	naivety, naiveness, naivete
fašist	fascist
nišan	aim, gunpoint
žaga	saw
trn	thorn 
familija	family
supa	soup
neboder	skyscraper
deran	mischievous boy, naughty boy
elektronika	electronics
tahta	board	plank	table	slab
kadet	cadet 
intriga	intrigue
šal	scarf
šapka	hat
juriš	charge	dash	onset	rush
karmin	lipstick
ruž	lipstick
halka	metal ring	door knocker	tilting at the ring 
potreba	need
zator	destruction, perdition, extermination
trezor	safe, vault
fakt	fact
prostitutka	whore, prostitute
štala	stable, stall
staja	stable
beleg	mark, marker	feature, trait, characteristic	birthmark	sign, signal, symptom
derbi	local derby
dikobraz	porcupine
predio	region, district, area	landscape 
užas	horror, terror
perec	pretzel
apologetika	apologetics
smrtnost	mortality
tajna	secret
slavina	faucet, tap
ovas	oat
infarkt	infarct	heart attack
sloga	unity, accord
busola	compass
stampedo	stampede
agda	sugar syrup
komedija	comedy
kanibal	cannibal
mizantrop	misanthrope
mizantropija	misanthropy
manuskript	manuscript
osveta	revenge, vengeance
dvojnik	look-alike, double
neven	marigold
kapsula	capsule
torba	bag	pouch, purse
slanost	saltiness
žar	fervor, ardor	ember
zanos	rapture	enthusiasm, ardor, fervor	delirium
umak	sauce 
sofist	sophist
terminologija	terminology
bakterija	bacterium
gravitacija	gravitation, gravity
vodovod	waterworks, plumbing
fetiš	fetish
doktrina	doctrine
invektiva	invective
kečap	ketchup
sumak	sumac
stetoskop	stethoscope
prodavač	salesman
četa	troop, squad, host
poezija	poetry
elektroda	electrode
filolog	philologist
anadiploza	anadiplosis
sakrament	sacrament
čokolada	chocolate
terorist	terrorist
ejakulacija	ejaculation
ejakulat	ejaculate
evolucija	evolution
etimolog	etymologist
autonomija	autonomy
zev	yawn
kameleon	chameleon
fotoreporter	newspaper or wire-service photographer, photojournalist
stilist	stylist
kreator	creator
produkcija	production
infrastruktura	infrastructure
zec	hare
terapeut	therapist
srna	roe deer
zigota	zygote
homozigot	homozygote
heterozigot	heterozygote
spavaćica	nightgown 
peršin	parsley
karizma	charisma
morž	walrus
buket	bouquet 
stepa	steppe
leska	hazel tree or bush, filbert	hazelwood stick
mudžahedin	mujahid
garderoba	dressing room
oftalmolog	ophthalmologist
balans	balance 
kampanja	campaign
dekret	decree
šaman	shaman
burek	a type of baked or fried filled pastry
kikiriki	peanut
konzerva	A tin, a can.
klovn	a silly, irresponsible person
proba	rehearsal	test, trial
žalo	beach, seaside, shore, sea bank
kohorta	cohort
tajga	taiga
čestina	frequency 
metabolizam	metabolism
mafija	mafia
širina	width, breadth
slad	malt
fosil	fossil
tradicija	tradition
samokontrola	self-control
banja	Turkish bath, steam bath
dužina	length
striper	a maker of comic strips; cartoonist
pitomost	tameness, docility
iskon	ancient origin, source, ancient era
pustoš	wasteland, desert	emptiness, solitude
padina	descent, decline, slope 
hanuma	wife	woman, lady
sloj	layer	stratum
šrot	buckshot	scrap
navoz	slipway
bankar	banker
predsednik	chairman	president
zloba	malice, rancor
pakost	malice, malevolence, meanness	malicious act or word
kolač	cake	pastry
hipi	hippie, hippy
čekić	hammer
čep	cork, stopper, cap
mitolog	mythologist
mitos	mythos
ontogeneza	ontogenesis
konsenzus	consensus
ceremonija	ceremony
banket	A banquet.
akšam	evening	dusk
registracija	registration
narkomanka	junkie, drug addict
poštar	postman
pasoš	passport
bakteriolog	bacteriologist
barel	barrel 
zbor	meeting, gathering
jela	fir
bakšiš	baksheesh
galon	gallon 
štafeta	relay 
bilder	bodybuilder
kaleidoskop	kaleidoscope
patolog	pathologist
hodža	hodja
jelek	waistcoat, vest	jelick
kvart	neighborhood, area
bostan	watermelon	melon	melon patch or melon garden
zumbul	hyacinth
telegraf	telegraph
impotencija	impotence, impotency	erectile dysfunction
valcer	waltz
krajnost	extreme
katapult	catapult
živina	fowl, poultry	cattle
skat	a type of card game played with 3 players, popular in Germany
samit	summit 
farma	farm
meduza	jellyfish
kontrola	control
prostitucija	prostitution
saft	sauce
kinin	quinine
dečak	a boy, youngster
piroga	canoe of shallow draft, made by hollowing a log; pirogue
mastodont	mastodon
artefakt	artifact
katastrofa	catastrophe
termosfera	thermosphere
litica	cliff
misal	missal
belac	A white horse
epitaf	epitaph
metafizika	metaphysics
gejša	geisha
tablica	tablet, slate	table 
repica	oilseed rape, 
šrapnel	shrapnel
kolino	knee
detektor	detector
trojka	troika
pesak	sand
prenos	transfer, transport	transmission	conveyancing	carrying over	cession
sepsa	sepsis
truba	trumpet
bova	buoy
blokada	blockade
devojka	girl, maiden
pešak	pedestrian
metastaza	metastasis
meteorograf	meteorograph
metodist	Methodist
prasak	crack, bang
veština	skill
miris	smell, odor
kriza	crisis
altituda	altitude
prognostičar	forecaster
materica	womb, uterus
bitka	battle
mudrost	wisdom
kopač	digger
tisa	yew-tree
oglas	advertisement	notice
prioritet	priority
vlakno	fibre
deklaracija	declaration
indeks	index
univerzum	universe
pomak	shift, movement
ocena	estimate, evaluation
prosek	average, mean
interpretacija	interpretation
spektar	spectrum
eksplozija	explosion
vernost	loyalty, fidelity
svedok	witness
sećanje	memory	recollection
teza	thesis
nagrada	prize	reward
slamka	drinking straw
crevo	gut, bowel, intestine
pozicija	position
oštrica	blade
heroj	hero
kult	cult
ivica	border, edge
diskusija	discussion, debate
situacija	situation
nalog	instruction, direction, orders
azil	asylum
vertikala	vertical
griža	dysentery	rocky or waterless area
skribent	hack, pen-pusher
provera	audit	check, checking	verification
ortografija	orthography
namet	tax, levy, excise
potpredsednik	vice president
industrija	industry
agrikultura	agriculture
šansa	chance, opportunity
dinamika	dynamics
korporacija	corporation
prizma	prism
čir	ulcer
kredit	credit, loan
propis	regulation, rule
ulog	investment
žila	vein	tendon
sindrom	syndrome
čar	charm, allure	spell, magic
striptiz	striptease
triftong	triphthong
bibliobus	mobile library
slatina	salt-spring
smirna	myrrh
žurka	party
svest	consciousness
spavačica	sleeper 
spisak	list	catalogue	register, inventory
srk	sip
staza	path, way
štap	staff, rod, stick
stoka	cattle
stremen	stirrup
strugar	sawyer, turner
sukno	cloth, stuff
suša	drought
sekretar	secretary
talir	thaler
tamburaš	tamburica player
tapetar	upholsterer
teža	gravitation
tikva	pumpkin
tkač	weaver
kadaif	kataifi
sačma	buckshot
taksista	taxi driver, cab driver
svrab	scabies	itch
pevač	singer
puškar	gunsmith
rabin	rabbi
spona	connection, link, bond
mužar	mortar
radič	radicchio
večnost	eternity
uprava	board of directors, directorate
huligan	hooligan
delegacija	delegation
poligraf	polygraph
kruna	crown
sezona	season
rekorder	record-holder
galerija	gallery
uzor	model, exemplar	ideal	standard
kafana	pub	tavern	coffeehouse
vodoinstalater	plumber
mezosfera	mesosphere
egzosfera	exosphere
kontekst	context
belaj	misfortune, calamity, trouble
suton	dusk, twilight
stolić	a small table
rešo	stove, cooker
mleč	beebread
šerif	sheriff
detalj	detail
kanjon	canyon 
konkubina	concubine
ksenofobija	xenophobia
zova	elderberry, elder
švalja	seamstress
zrelost	maturity	ripeness
energija	energy
šestina	one sixth
sedmina	one seventh
osmina	one eighth
desetina	one tenth
fruktoza	fructose
kopča	clasp	buckle	hook
lončar	potter
ultrazvuk	ultrasound
ciklus	cycle
palačinka	pancake, crêpe
krajnik	tonsil
čestar	thicket, copse, coppice
hibrid	hybrid
hipnoza	hypnosis
hrid	cliff
žarište	focus	hotbed
institucija	institution
odbor	committee, board
maćeha	stepmother
eliksir	elixir
terapija	therapy
narkotik	narcotic
frajer	guy	an attractive man, hunk	dandy, fop	an arrogant man	a naive man	loafer
buba	bug	beetle
muzikologija	musicology
šafran	saffron
sindikat	syndicate 
snajper	a long-range small arms for precise attacks
ideologija	ideology
organizator	organizer
ekipa	team, crew
škorpion	scorpion
toalet	toilet
trik	trick
optimizam	optimism
diler	drug dealer
parfem	perfume
korota	mourning
tajfun	typhoon
ovoj	wrapping, shell, casing, covering
koncentracija	concentration
balada	ballad
izlaz	exit
zulum	violence, terror, tyranny	injustice
potera	chase, pursuit
letak	leaflet, flyer
poraz	defeat
vinar	vintner
železnica	railway
melasa	molasses
dinastija	dynasty
naslednik	heir, inheritor	successor
monarhija	monarchy
kasarna	barracks
uzurpator	usurper
pandur	tipstaff
kajiš	belt
đubre	manure	trash, garbage	very bad and immoral person
čerga	a small tent
zavet	covenant	oath, promise	will, testament
barok	Baroque
zakup	tenure	lease
periskop	periscope
poklon	gift, present
katolik	Catholic
veštica	witch, sorceress	harridan, hag
arheolog	archeologist
biograf	biographer
freska	fresco
kancelar	chancellor
navod	quotation
rudar	miner
tkanina	fabric, textile
zavoj	bandage
zbornik	miscellany, anthology
egiptolog	Egyptologist
ratar	agriculturist, soil cultivator
kopriva	nettle
lasica	weasel
papirus	papyrus
tetrarh	tetrarch
diktatura	dictatorship
krčmar	innkeeper, tavern owner
trening	training, training session
mentalitet	mentality
dizajn	design
nasilnik	bully
ritam	rhythm
rukola	arugula
celost	totality, whole, entirety	state of totality, as opposed to that in pieces
povod	motive, reason
pevac	rooster, cock
bošča	veil, kerchief	tablecloth	quadrangle-shaped piece of canvas used for wrapping	bundle, package	a type of tobacco
palanka	a small town on the Balkans	a type of wooden fortress on the roads of Ottoman Empire built for the protection of travelers
ugor	eel
čredo	flock	herd
čreda	flock	herd
pilav	pilaf
mišar	buzzard
forinta	forint
ludilo	madness, insanity
navrat	time, instance, occasion of doing something, especially in phrase:
blesak	glare, shine
turnir	tournament
eklipsa	eclipse
donos	that which is brought
zeba	chaffinch
zavodnik	seducer
nekrolog	obituary 
celuloza	cellulose
bibliotekar	librarian
petarda	firecracker	petard
čauš	a rank of non-commissioned officer in the Ottoman Turkish army	town crier
nizina	lowland
gaj	grove
vitraž	stained glass window
rezbar	carver, engraver
ugoda	pleasantness, delightfulness, agreeableness	comfortableness, cosiness
suši	sushi
poliklinika	polyclinic
luda	madman, insane person
paša	pasha
pomada	ointment, cream	pomade
impuls	momentum, impetus
doktorand	a PhD student, a person studying for a doctorate
normalnost	normality, normalcy
opaska	note, remark
krš	karst	rocky terrain	thrash, rubbish, debris, mess
samotnik	loner
nakana	intention, intent
gabor	hideous or disgusting person or thing; eyesore, freak, monstrosity
orač	tiller, plowman
ćup	jug, jar
lombard	pawn, security
naum	intention	aim, goal
violončelo	cello
masiv	massif
psihopat	psychopath
varka	illusion	trick, swindle
identitet	identity
brauzer	web browser
paralaksa	parallax
kabaret	cabaret
ubijač	killer, murderer
kosina	slope, slant
lateks	latex
trigonometrija	trigonometry
plodina	crop
nakot	brood
koliba	hut, cottage, cabin
reputacija	reputation
prestup	misdoing, violation, transgression, offense
oksid	oxide
poteg	movement
pomagač	helper
šiba	rod, switch, wand
teletekst	Teletext
badnjak	Yule log
budak	pickax, mattock
klozet	water closet, WC	toilet
kolonist	colonist, settler
partizan	partisan, follower
nakan	intent
bestseler	bestseller
pregrada	obstacle, bar
graja	hubbub, clamor, noise
žabar	frog-catcher
kaljuga	mud	puddle
gruda	lump, clod	snowball
citra	zither
zbir	sum, total
pleće	shoulder blade	shoulder
ubod	sting, stab, prick
delić	small part
mrva	crumb
naboj	cartridge 	charge 
vitraj	stained glass
kupola	cupola
jal	envy	malice
struk	waist	stalk, stem
arebica	A form of the Perso-Arabic script once used to write Serbo-Croatian.
dupin	dolphin
federacija	federation
fiziolog	physiologist
fiziologija	physiology
parafraza	paraphrase
kapilara	capillary
karantena	quarantine
kardiolog	cardiologist
kartaš	card player	gambler
kartograf	cartographer
kilobajt	kilobyte
gigabajt	gigabyte
megabajt	megabyte
imela	mistletoe
imigracija	immigration
improvizator	improviser
individuum	individual
inkubator	incubator
inspiracija	inspiration
opozicija	opposition
oseka	low tide	ebb tide, ebb
paranoja	paranoia
kremen	flint
odron	rockslide, landslide
oligarh	oligarch
oligarhija	oligarchy
omotač	wrapping, wrapper, cover, covering, envelope	shell, casing
kolonija	colony
kompresor	compressor
koncentrat	concentrate
koncepcija	conception
konfederacija	confederation
nakaza	freak, monster
naušnica	earring
kandža	claw
partija	political party
pasus	paragraph
patnik	sufferer, wretch
patricij	patrician
patrola	patrol
mlekar	milkman
monsun	monsoon
čip	chip
čitanka	textbook, reader
levica	left hand	political left
diletant	dilettante
doza	dose, dosage
ekstaza	ecstasy
emancipacija	emancipation
epigraf	epigraph
evakuacija	evacuation
psiha	psyche
verbalizam	verbosity
žir	acorn
samica	solitary confinement cell
zavod	institute, office, bureau
marš	march
plen	booty, plunder
insekticid	insecticide
toksin	toxin
troglodit	troglodyte
međa	border, boundary
trun	tiny piece, bit, scrape
topić	small cannon
tajac	silence, hush
teror	terror
šlem	helmet
štaka	crutch
surogat	surrogate, substitute
vonj	stench	odor, smell
kodeks	codex
kofer	suitcase
kolaž	collage
kolhoz	kolkhoz
klimaks	climax
eksces	excess
emigracija	emigration
dvosed	two-seater
fasada	facade
letopis	annal	chronicle	yearbook
kvantitet	quantity
biftek	beefsteak
perina	pillow
jurta	yurt
scenograf	scenographer
selektor	selector
impulzivnost	impulsiveness
hrt	greyhound
ilustrator	illustrator
intelekt	intellect
restoran	restaurant
investitor	investor
krasota	beauty
kupač	swimmer	bather
kuče	young dog; puppy
kvota	quota
latica	petal
limuzina	limousine
poseta	visit
kupleraj	brothel, whorehouse
kupler	pimp
carević	tsarevich
steg	flagpole, flagstaff
lutak	puppet, doll
haubica	howitzer
konfiguracija	configuration
konfesija	confession
komentator	commentator
korupcija	corruption
kvorum	quorum
kufer	suitcase
ezan	adhan
luteran	Lutheran
maksimum	maximum
maršal	marshal
misionar	missionary
jebač	fucker
tužba	complaint
farmakologija	pharmacology
podjela	division, distribution	classification
solidarnost	solidarity
novina	novelty, innovation
speleologija	speleology
spirala	spiral
spev	poem	canto
simptom	symptom
senka	shade; shadow
skalpel	scalpel
skleroza	sclerosis
skolastika	scholasticism
skorbut	scurvy
skulptura	sculpture
sifilis	syphilis
flebitis	phlebitis
refraktor	refractor
lokum	Turkish delight
didaktika	didactics
rvač	wrestler
repertoar	repertoire
gospa	Mrs.
aerobik	aerobics
vakcina	vaccine
pubertet	puberty
proslov	prologue
provokacija	provocation
prelom	turning point
primesa	mixture	alloy	ingredient, admixture	addition
žig	stamp, brand
gastarbajter	guest worker
dren	specifically European cornel
trajekt	ferry
usud	fate, destiny
ološ	riffraff, rabble
domet	range, reach	scope
klada	dunce, dumb person
konvent	convent
hatar	region, district, area, land
paranoik	paranoid, paranoiac 
plima	high tide	flood tide
obest	wantonness
resor	a branch of government
arabeska	arabesque
avantura	adventure
arhipelag	archipelago
apoteoza	apotheosis 
bogoslov	theologian
batak	leg 
žleb	groove, flute	gutter	drainpipe, downspout
žongler	juggler
žigolo	gigolo
pribor	tool, instrument, gadget, apparatus	cutlery
žalac	barb, biting remark
zubac	cog
zlatnik	gold coin
elaborat	study, report, survey
zelot	zealot
zavada	quarrel
nacist	Nazi
fonograf	phonograph
menopauza	menopause
hektogram	hectogram
harlekin	harlequin
guverner	governor
dekagram	decagram
hodač	walker
narkoza	narcosis
grimasa	grimace
hipodrom	hippodrome
aplikacija	application
centralizam	centralism
centralizacija	centralization
cenzor	censor
cepelin	zeppelin
izolator	insulator
putar	butter	roadman
nimfomanka	nymphomaniac
flegma	phlegm, apathy	phlegmatic person
rasist	racist
kolar	wheelwright
blef	bluff
tretman	treatment
carevna	tsarevna
učenost	learning, erudition
groš	groschen	pin money
humoreska	lighthearted short story	humoresque 
prefektura	prefecture
mušica	whim, caprice
groza	horror, terror, dread, shiver
neuroza	neurosis
nonkonformist	nonconformist
crta	line	trait, feature
brokat	brocade
protektorat	protectorate
prisnost	closeness, intimacy
naklon	bow, courtesy
ekstrakt	extract
etnologija	ethnology
mikrobiologija	microbiology
tipologija	typology
elektrolit	electrolyte
elektromagnet	electromagnet
staž	work experience	training period, internship
uvala	valley	inlet, cove
konkordat	concordat
ukus	taste, as in a person’s implicit set of preferences, especially esthetic, though also culinary, sartorial, etc.
vapno	lime
galica	chough
kotac	pigsty	dirty, filthy place
kustos	custodian, curator
lovište	hunting ground or area
izoglosa	isogloss
mešina	goatskin, wineskin
kalifat	caliphate
burleska	burlesque
celuloid	celluloid
kurtizana	courtesan
kurziv	italics
čeno	clove 
overa	notarization; stampin with an official seal
šav	seam
šarm	charm
dreka	shouting, screaming	noise, uproar, racket
drem	slumber, doze
hren	horseradish
htenje	willingness, willing, determination	desire, wish
hurikan	hurricane
husit	Hussite
ihtiolog	ichthyologist
iluzionist	illusionist
inat	spite, obstinacy
invaliditet	disability
šema	scheme, model, plan, outline, sketch
plašt	mantle, cloak, cape
platac	payer
rezultanta	resultant
zaraza	contagion	infection
zaton	bay	gulf
psiholog	psychologist
psihoza	psychosis
mejdan	a larger empty area in a city, usually of Oriental type; square, field
pudl	poodle
pudla	poodle
konspiracija	secrecy, security measures
ipokrit	hypocrite 
felacija	fellatio
liz	a lick 
felga	rim
nekrofilija	necrophilia
ginekolog	gynaecologist
halja	plain robe, habit
karikaturist	caricaturist	cartoonist
limfa	lymph
hira	whey
nauk	lesson	moral
nećakinja	niece
nećak	nephew
topuz	cudgel, mace, club
sprinterka	sprinter 
ginekologija	gynecology
sinod	synod
tonzura	tonsure
prezbiter	presbyter, priest
epistemologija	epistemology
eparh	eparch
prepona	hurdle, obstacle
kadaver	cadaver
lemeš	plowshare
pasat	trade wind
drač	thorny bush, bramble
prevrat	turning point, revolution
kefa	brush
fleka	spot, smear, blot
manira	a manner	etiquette
melem	balm, balsam
anabolik	anabolic
torbar	peddler
zamak	fortress, castle
drot	wire
štok	doorframe
restaurator	restorer
himen	hymen
rešt	prison
karburator	carburetor
šlapa	slipper
vuga	oriole
gromada	heap	pile	mass
jova	alder
štempl	stamp	seal
broć	madder
milje	milieu
milja	mile
beštek	silverware, cutlery, set of instruments used to take in food
autoportret	self-portrait
štrik	rope, cord
štof	fabric	material
štikla	high heels
šteker	plug	socket
cokl	pedestal	support
špek	bacon	fat
bušel	bushel
gušt	pleasure	taste
okret	turn, revolution
inč	inch
direktor	manager, head, executive
rezidencija	residency	residence
šleper	tug
šlager	Schlager
kolovrat	spinning wheel	whirlpool
tenje	shadow
mlezivo	colostrum
disident	dissident
punina	fulness
štiglic	goldfinch
štiglić	goldfinch
ćela	bald spot
hispanistika	Hispanic studies, Spanish studies
duplikat	duplicate
šar	firmament, welkin	natural beauty
prolom	breach, gap, rupture
popularizator	popularizer
memoar	memoir
neurotik	neurotic
preambula	preamble
hulja	scoundrel, rascal, knave
ploha	surface, area	facet, face
šmrk	hose	pump	snivel, snot
trač	gossip, gossiping
inbus	hex key, Allen key
venerolog	venereologist
verglaš	organ grinder
verzal	text written in capital letters or majuscule	printing in capital letter
pobuda	motive, motivation, inspiration
kiper	dump truck
zlica	an evil person
semenik	testicle
dača	dacha 
urez	notch, cut
sivac	grey/gray horse
malj	mallet, hammer
posekotina	cut, laceration
muza	muse
brač	a type of instrument, similar to tamburica
vrelo	well, wellspring
pizma	spite, malice	hatred
harpunar	harpooner
kružok	circle, group, society
lokna	curl, lock
lopar	asp, 
lopatar	fallow deer
losion	lotion
makadam	macadam
paprikaš	paprikash
ogar	sighthound
irha	the skin of a sheep with the fleece removed
trs	stalk of a grapevine
budoar	boudoir
budža	a powerful person; figurehead, kingpin, bigwig
bujon	bouillon
bukovina	beechwood
predivo	yarn
prefekt	prefect
šos	skirt
berba	picking, gathering 	harvest
bezbožnik	atheist
barakuda	barracuda
karpa	hill
tuka	turkey 
listak	Hypocoristic form of 
dilum	a slice obtained by longitudinal cutting
kapura	reticulum, bonnet, the second compartment of the stomach of a ruminant
sardela	sardine	pilchard
sekret	secretion
škart	bad goods	waste, crap
samovlada	autocracy
brile	ski sunglasses
saksofonist	saxophonist
klaster	cluster
sapunar	soap manufacturer
ruzmarin	rosemary
salamandar	newt, salamander
sekstant	sextant
pleća	shoulders, back
laburist	Labour Party member or adherent
licenca	licence
licencija	license
lođa	loggia
poruga	mockery, ridicule
ciča	severe frost; frostiness	sharpness of cold, coldness
smirak	emery
štanca	stamp 
štand	stall, booth, bench, stand 
štamgast	regular 
šrafa	a line within a hatching
šprung	scratch
špula	spool
štacija	station	hangout 
štab	headquarters	panel of experts
šnit	cut
šnorer	schnorrer
kredenc	dresser 
kotar	country, district
kreket	croak, croaking 
kotlar	boiler maker
kozar	goatherd
kozarstvo	goat breeding
kožar	skinner, tanner, currier
krajišnik	borderer, frontiersman	soldier from the Military Frontier or the Croatian Military Frontier
kraval	ruckus
teksas	denim
bešamel	béchamel sauce 
krnjak	stub, stump, rump 
kroki	sketch, croquis
filc	felt
ćoza	snowshoe
štras	strass
debi	debut
defetist	defeatist
delikt	delict, offence
pamfletist	pamphleteer
paleontologija	paleontology
šimšir	box 
šib	rod
delikatesa	delicacy 
novak	recruit	novice
cevka	tubule
čađa	soot
pisak	mouthpiece, reed
gugut	cooing
fizioterapeut	physical therapist
fizioterapija	physiotherapy
fotoaparat	camera 
tehnolog	technologist
telefonist	telephonist
stavka	item, entry 
odel	department, section
plotun	salvo, volley 
saten	satin
šaš	sedge 	reed
rogoz	bullrush, sedge, reed
kuter	cutter 
plašilo	bugaboo, scarecrow
supervizor	supervisor
zadak	abdomen 
ofenziva	offensive	offense
guž	non-venmous snake
ažur	openwork, a-jour-work	cutwork	drawn-thread work, hemstitch
čardaš	czardas 
kuplung	clutch
želud	acorn
mlat	thresher	mallet, hammer
krupa	hail
klasik	classic 
žbir	informer	spy
hunta	junta
ginko	ginkgo
honved	Hungarian volunteer army	Hungarian home guard	Hungarian army
brodar	ferryman 	boatman, sailor; one who works with ships or whose profession is shipping or navigation
polet	a taking flight, takeoff	enthusiasm, elation, spirit	quick, strong growth; progress
školj	islet	reef
litota	litotes 
azilant	asylum seeker
avanturist	details
aršin	arshin	yardstick 
digitron	calculator
korab	riverboat	hull of a ship
ilik	a loop or eye for a button or hook on clothing, buttonhole	an ornament on such a hole, buttonhole, boutonniere
kamenik	stone mine
mušketa	musket
išpan	feudal supervisor
špan	feudal supervisor
remiza	carriage house
foršpan	trailer
pedalin	waterbike
urod	crop, yield
srča	shards of glass
struga	sheepfold	goatpen
arbun	the 
pošada	knife
zdenka	processed cheese
pogon	drive, propulsion 	motor 	workshop, plant, works
prođa	sales, market 
pića	drinks, beverages
traktorista	tractor driver
kipar	sculptor as a profession	The constellation sculptor
sirilo	rennet
arhivar	archivist
arhivist	archivist
hektopaskal	hectopascal
srok	rhyme
bašton	clubs in Spanish playing cards
žandar	gendarme
perga	beebread
skrobut	clematis
arzuhal	petition
skvoš	squash
stehiometrija	stoichiometry
durbin	prospective, perspective glass, monocular, spyglass, telescope
ajran	airan, a traditional drink made of yoghurt, water and salt
remont	repair, renovation
dolama	dolman 	any long robe or mantle that falls below the knees	dolman 
čivit	indigo dye
teša	clothes
galka	jackdaw
svat	matchmaker	attendant of a wedding
mezga	sapwood
biskupija	bishopric, diocese
rešetar	sievemaker
polnoć	midnight
šivač	seamster
demografija	demography
diba	gold-damascened silk brocade 
jedek	parade horse	halter rope, rope by which a horse is tied or led	mooring rope, rope by which a boat is tied	tug-of-war	spare or reserve part of some equipment
homeopatija	homeopathy
pačavra	rag, wiping cloth
